#######
# .   #
# # # #
# # # #
# $@  #
#     #
#######