#######
#  .  #
#  $  #
#  @  #
#     #
#######