#######
#  .  #
#  #  #
#  $  #
#  @  #
#     #
#######